107
15
19 19 16 0 0 0 0 0 0 0 0 0 0 0 0 0 0 0 0 0 0 0 0 0 0 0 0 0 0 0 0 0 0 0 0 0 0 0 0 0 0 0 0 3 18 18 18 18 18 18 18 18 18 18 18 18 18 18 18 18 18 18 18 18 18 18 18 18 18 18 18 18 18 18 18 4 0 0 0 0 0 0 0 0 0 0 0 0 0 0 3 18 18 18 18 18 18 18 18 18 18 18 18 18 18 18 18 
19 16 0 0 0 0 0 0 0 0 0 0 0 0 0 0 0 0 0 0 0 0 0 0 0 0 0 0 0 0 0 0 0 0 0 0 0 0 0 0 0 0 0 0 18 18 18 18 18 18 18 18 18 18 18 18 18 18 18 18 19 17 17 17 17 17 17 17 17 17 18 18 18 18 18 4 0 0 0 0 0 0 0 0 0 0 0 0 0 0 0 18 18 18 18 18 18 19 17 17 17 17 17 17 17 18 18 
19 0 0 0 0 0 0 0 0 0 0 0 0 0 0 0 0 0 14 0 0 0 0 0 0 0 0 0 0 0 0 0 0 0 0 0 0 0 0 0 10 0 0 0 0 17 17 17 18 18 18 18 18 18 18 18 18 18 18 18 4 0 0 16 0 0 0 0 0 0 0 17 18 18 18 4 0 0 0 0 0 0 0 0 0 0 0 0 0 0 0 0 18 18 18 18 18 4 0 0 0 0 0 0 0 3 18 
19 0 0 0 0 0 0 0 0 0 0 0 0 0 0 11 0 0 0 0 0 0 0 0 0 0 0 0 0 0 0 0 0 0 11 0 0 0 0 0 0 0 0 0 0 0 0 0 0 17 17 18 18 18 18 18 18 18 18 19 0 0 10 0 11 0 0 0 0 0 0 0 0 17 17 0 0 0 0 9 0 0 0 0 1 18 2 0 0 0 0 0 0 18 18 18 18 4 0 0 0 0 0 0 0 3 18 
0 0 0 0 0 0 0 0 0 0 0 0 11 1 18 18 2 0 0 0 0 0 0 0 0 0 0 15 0 0 0 0 0 0 0 0 0 0 0 0 0 0 0 0 0 9 11 0 0 0 0 0 17 17 17 17 17 17 17 0 0 1 18 18 18 2 0 0 0 0 0 0 0 0 0 0 0 0 0 0 0 0 0 0 3 18 4 0 0 0 0 0 0 0 18 18 18 4 0 0 0 0 0 0 0 3 18 
0 0 0 0 0 0 0 0 0 0 1 18 18 18 6 18 4 0 0 0 0 0 10 9 0 0 0 0 0 0 10 0 0 0 0 0 0 11 0 0 0 0 0 1 18 18 18 18 2 0 0 0 9 0 0 0 0 9 0 0 0 3 18 18 18 4 0 0 0 0 0 0 0 0 0 0 0 0 0 0 0 0 0 0 3 18 4 0 0 0 0 0 0 0 0 17 17 0 0 0 0 0 0 0 0 3 18 
0 0 9 0 0 0 0 0 0 11 3 18 18 18 18 18 4 0 0 0 1 18 18 18 18 2 0 0 9 1 18 18 2 0 9 1 18 18 2 0 0 0 0 3 18 18 18 18 4 10 0 1 18 2 0 0 1 18 2 11 1 18 6 18 18 4 0 0 0 0 0 0 0 9 0 0 10 9 0 0 11 0 0 1 18 5 18 2 0 0 0 0 0 0 0 0 0 0 0 10 11 0 0 9 0 3 18 
0 0 0 0 0 0 0 0 0 0 0 6 0 0 0 0 4 0 0 0 3 18 18 18 18 18 18 18 18 18 6 5 18 18 18 18 6 18 4 0 0 0 0 3 18 18 18 5 18 18 18 18 18 18 18 18 18 18 18 18 18 6 18 18 18 4 0 0 0 0 0 1 18 18 18 18 18 18 18 18 18 18 18 18 6 18 5 18 18 18 18 18 18 18 18 18 18 18 18 18 18 18 18 18 18 18 6 
0 0 0 0 0 12 13 0 0 0 0 0 0 0 0 0 0 0 0 0 0 0 0 0 0 0 0 0 0 0 0 0 0 0 0 0 0 0 0 0 0 0 0 3 18 18 18 18 18 18 18 18 18 18 18 18 18 18 18 18 18 18 18 18 18 18 18 18 18 18 18 18 18 18 18 4 0 0 0 0 0 0 0 0 0 0 0 0 0 0 3 18 18 18 18 18 18 18 18 18 18 18 18 18 18 18 18 
0 0 0 0 0 0 0 0 0 0 0 0 0 0 0 0 0 0 0 0 0 0 0 0 0 0 0 0 0 0 0 0 0 0 0 0 0 0 0 0 0 0 0 0 18 18 18 18 18 18 18 18 18 18 18 18 18 18 18 18 19 17 17 17 17 17 17 17 17 17 18 18 18 18 18 4 0 0 0 0 0 0 0 0 0 0 0 0 0 0 0 18 18 18 18 18 18 19 17 17 17 17 17 17 17 18 18 
10 0 11 0 0 0 0 0 0 0 0 0 0 0 0 0 0 0 14 0 0 0 0 0 0 0 0 0 0 0 0 0 0 0 0 0 0 0 0 0 10 0 0 0 0 17 17 17 18 18 18 18 18 18 18 18 18 18 18 18 4 0 0 16 0 0 0 0 0 0 0 17 18 18 18 4 0 0 0 0 0 0 0 0 0 0 0 0 0 0 0 0 18 18 18 18 18 4 0 0 0 0 0 0 0 3 18 
18 18 18 0 0 0 0 0 0 0 0 0 0 0 0 11 0 0 0 0 0 0 0 0 0 0 0 0 0 0 0 0 0 0 11 0 0 0 0 0 0 0 0 0 0 0 0 0 0 17 17 18 18 18 18 18 18 18 18 19 0 0 10 0 11 0 0 0 0 0 0 0 0 17 17 0 0 0 0 9 0 0 0 0 1 18 2 0 0 0 0 0 0 18 18 18 18 4 0 0 0 0 0 0 0 3 18 
19 19 19 0 0 0 0 0 0 0 0 0 11 1 18 18 2 0 0 0 0 0 0 0 0 0 0 15 0 0 0 0 0 0 0 0 0 0 0 0 0 0 0 0 0 9 11 0 0 0 0 0 17 17 17 17 17 17 17 0 0 1 18 18 18 2 0 0 0 0 0 0 0 0 0 0 0 0 0 0 0 0 0 0 3 18 4 0 0 0 0 0 0 0 18 18 18 4 0 0 0 0 0 0 0 3 18 
19 19 19 18 18 18 18 18 18 18 1 18 18 18 6 18 4 0 0 0 0 0 10 9 0 0 0 0 0 0 10 0 0 0 0 0 0 11 0 0 0 0 0 1 18 18 18 18 2 0 0 0 9 0 0 0 0 9 0 0 0 3 18 18 18 4 0 0 0 0 0 0 0 0 0 0 0 0 0 0 0 0 0 0 3 18 4 0 0 0 0 0 0 0 0 17 17 0 0 0 0 0 0 0 0 3 18 
19 19 19 19 19 19 19 19 19 19 18 6 18 18 18 18 4 0 0 0 3 18 18 18 18 18 18 18 18 18 6 5 18 18 18 18 6 18 4 0 0 0 0 3 18 18 18 5 18 18 18 18 18 18 18 18 18 18 18 18 18 6 18 18 18 4 0 0 0 0 0 1 18 18 18 18 18 18 18 18 18 18 18 18 6 18 5 18 18 18 18 18 18 18 18 18 18 18 18 18 18 18 18 18 18 18 6