107
17
40 00 00 00 00 00 00 00 00 00 00 00 00 00 00 00 00 00 00 00 00 00 00 00 00 00 00 00 00 00 00 00 00 00 00 00 00 00 00 00 00 00 00 00 00 00 00 00 00 00 00 00 00 00 00 00 00 00 00 00 00 00 00 00 00 00 00 00 00 00 00 00 00 00 00 00 00 00 00 00 00 00 00 00 00 00 00 00 00 00 00 00 00 00 00 00 00 00 00 00 00 00 00 00 00 00 44
40 00 00 00 00 00 00 00 00 00 00 00 00 00 00 00 00 00 00 00 00 00 00 00 00 00 00 00 00 00 00 00 00 00 00 00 00 00 00 00 00 00 00 00 00 00 00 00 00 00 00 00 00 00 00 00 00 00 00 00 00 00 00 00 00 00 00 00 00 00 00 00 00 00 00 00 00 00 00 00 00 00 00 00 00 00 00 00 00 00 00 00 00 00 00 00 00 00 00 00 00 00 00 00 00 00 44
40 00 00 00 00 00 00 00 00 00 00 00 00 00 00 00 00 00 00 00 00 00 00 00 00 00 00 00 00 00 00 00 00 00 00 00 00 00 00 00 00 00 00 00 00 00 00 00 00 00 00 00 00 00 00 00 00 00 00 00 00 00 00 00 00 00 00 00 00 00 00 00 00 00 00 00 00 00 00 00 00 00 00 00 00 00 00 00 00 00 00 00 00 00 00 00 00 00 00 00 00 00 00 00 00 00 44
40 00 00 00 00 00 00 00 00 00 00 00 00 00 00 00 00 00 00 00 00 00 00 00 00 00 00 00 00 00 00 00 00 00 00 00 00 00 00 00 00 00 00 00 00 00 00 00 00 00 00 00 00 00 00 00 00 00 00 00 00 00 00 00 00 00 00 00 00 00 00 00 00 00 00 00 00 00 00 00 00 00 00 00 00 00 00 00 00 00 00 00 00 00 00 00 00 00 00 00 00 00 00 00 00 00 44
40 00 00 00 00 00 00 00 00 00 00 00 00 00 00 00 00 00 00 00 00 00 00 00 00 00 00 00 00 00 00 00 00 00 00 00 00 00 00 00 00 00 00 00 00 00 00 00 00 00 00 00 00 00 00 00 00 00 00 00 00 00 00 00 00 00 00 00 00 00 00 00 00 00 00 00 00 00 00 00 00 00 00 00 00 00 00 00 00 00 00 00 00 00 00 00 00 00 00 00 00 00 00 00 00 00 44
40 00 00 00 00 00 00 00 00 00 00 00 00 00 00 00 00 00 00 00 00 00 00 00 00 00 00 00 00 00 00 00 00 00 00 14 24 15 00 00 00 00 00 00 00 00 00 00 00 00 00 00 00 00 00 00 00 00 00 00 00 00 00 00 00 00 00 00 00 00 00 00 00 00 00 00 00 00 00 00 00 00 00 00 00 00 00 00 00 00 00 00 00 00 00 00 00 00 00 00 00 00 00 00 00 00 44
40 00 00 00 00 00 00 00 00 00 00 00 00 00 00 00 00 00 00 00 00 00 00 00 14 24 14 00 00 00 00 00 00 00 00 00 00 00 00 00 00 00 00 00 00 00 00 00 00 00 00 00 00 00 00 37 38 39 00 00 00 00 00 00 00 00 00 00 00 00 00 00 00 00 00 00 00 00 37 38 39 00 00 00 00 00 00 00 00 00 00 00 00 00 00 00 00 00 00 00 00 00 00 00 00 00 44
40 00 00 00 00 00 00 00 00 00 00 00 00 00 00 00 00 00 00 00 00 00 00 00 00 00 00 00 00 00 00 00 00 00 00 00 00 00 00 00 00 00 00 00 00 00 00 41 43 00 00 00 00 00 00 44 45 46 00 00 00 00 00 00 00 00 00 00 00 00 00 00 00 00 00 00 00 65 66 45 63 64 00 00 00 00 00 00 00 00 00 00 00 00 00 00 00 00 00 00 00 00 00 00 00 00 44 
40 00 00 00 00 00 00 00 00 00 00 00 00 00 00 00 00 00 00 00 00 00 00 00 00 00 00 00 00 00 00 00 00 00 00 00 00 00 00 00 00 00 00 00 00 00 00 00 00 00 00 00 00 00 00 44 45 46 00 00 00 00 00 00 00 00 00 00 00 00 00 00 00 00 00 00 00 00 44 45 46 00 00 00 00 00 00 00 00 00 00 00 00 00 00 00 00 00 00 00 00 00 00 65 67 67 66
40 00 00 00 12 13 00 00 00 00 00 00 14 00 00 00 00 00 00 00 00 00 00 00 00 00 00 00 00 00 41 42 42 43 00 00 00 00 00 00 00 00 00 00 00 00 00 00 00 00 00 00 00 00 00 44 45 46 00 00 00 00 00 00 00 00 00 00 00 00 00 00 00 00 00 00 00 00 44 45 46 00 00 00 00 00 00 00 00 00 00 00 00 00 00 00 00 00 00 00 00 00 00 00 00 00 44
40 00 00 00 00 00 00 00 00 00 00 00 00 00 00 00 00 00 00 00 00 00 00 00 00 00 00 00 00 00 00 00 00 00 00 00 00 00 00 00 00 00 00 00 00 00 00 00 00 00 00 00 00 00 00 44 45 46 00 00 00 00 00 00 00 00 00 00 00 00 00 00 00 00 00 00 00 00 44 45 46 00 00 00 00 00 00 00 00 00 00 00 00 00 00 00 00 38 38 38 00 00 00 00 00 00 44
40 00 11 00 00 00 00 00 00 00 00 00 00 00 00 37 39 00 00 00 00 00 00 00 00 00 00 00 00 00 00 00 00 00 00 00 00 00 00 00 00 00 00 00 00 00 00 00 00 41 42 43 00 00 00 44 45 46 00 00 00 00 00 00 00 00 00 00 00 00 00 00 00 00 00 00 00 65 66 45 63 64 00 00 00 00 38 38 38 38 38 38 38 38 38 00 00 44 45 46 00 00 00 00 00 00 44 
40 38 38 39 00 00 00 00 00 00 00 00 00 00 00 44 46 00 00 00 00 00 00 00 37 39 00 00 00 00 00 00 00 00 00 00 00 00 00 00 00 00 00 00 00 00 00 00 00 00 00 00 00 00 00 44 45 46 00 00 00 00 00 00 00 00 00 00 00 00 00 00 00 00 00 00 00 00 44 45 46 00 00 00 00 00 44 45 45 45 45 45 45 45 46 00 00 44 45 46 00 00 00 00 00 00 44
50 45 50 46 00 00 00 10 00 00 00 00 00 09 00 44 63 67 67 64 00 00 00 00 44 46 00 00 00 00 00 00 00 00 00 00 00 00 00 00 00 00 00 00 00 00 00 00 00 00 00 00 00 00 00 44 45 46 00 00 00 00 00 00 00 37 38 38 38 38 38 38 38 38 38 39 00 00 44 45 46 00 00 00 00 00 44 45 45 45 45 45 45 45 46 00 00 44 45 46 00 00 00 00 00 00 44
45 50 45 61 38 38 38 38 38 38 38 38 38 38 38 62 46 00 00 00 00 00 37 38 62 61 39 00 00 00 00 00 00 00 00 00 00 00 00 00 00 00 00 37 38 38 39 00 00 00 00 00 00 00 37 62 45 61 39 00 00 00 00 00 00 44 45 45 45 45 45 45 45 45 45 46 00 00 44 45 46 00 00 00 00 00 44 45 45 45 45 45 45 45 46 00 00 44 45 46 00 00 00 00 00 00 44
45 45 45 50 45 45 45 50 45 45 45 45 50 45 45 45 46 00 00 00 00 00 44 45 45 45 46 00 00 00 00 00 00 00 00 00 00 00 00 00 00 00 00 44 45 45 46 00 00 00 00 00 00 00 44 45 45 45 46 00 00 00 00 00 00 44 45 45 45 45 45 45 45 45 45 46 00 00 44 45 46 00 00 00 00 00 44 45 45 45 45 45 45 45 46 00 00 44 45 46 00 00 00 00 00 00 44
45 45 45 45 45 50 45 45 45 45 45 45 45 45 45 45 46 00 00 00 00 00 44 45 45 45 46 00 00 00 00 00 00 00 00 00 00 00 00 00 00 00 00 44 45 45 46 00 00 00 00 00 00 00 44 45 45 45 46 00 00 00 00 00 00 44 45 45 45 45 45 45 45 45 45 46 00 00 44 45 46 00 00 00 00 00 44 45 45 45 45 45 45 45 46 00 00 44 45 46 00 00 00 00 00 00 44