25
20
62 61 61 61 61 61 61 61 61 61 61 61 61 61 61 61 61 61 61 61 61 61 61 61 61
59 23 23 23 22 23 23 23 22 23 23 23 22 23 23 23 22 23 23 23 22 23 23 23 57
59 23 23 23 22 23 23 23 22 23 23 23 22 23 23 23 22 23 23 23 22 23 23 23 57
59 23 21 23 22 23 21 23 22 23 21 23 22 23 23 23 22 23 23 23 22 23 23 23 57
59 23 23 23 22 23 23 23 22 23 23 23 22 23 23 23 22 23 23 23 22 23 23 23 57
59 23 23 23 22 23 23 23 22 23 23 23 22 23 23 23 22 23 23 23 22 23 23 23 57
59 23 23 23 22 23 23 23 22 23 23 23 22 23 23 23 22 23 23 23 22 23 23 23 57
59 23 23 23 22 23 23 23 22 23 23 23 22 23 23 23 22 23 23 23 22 23 23 23 57
59 23 23 23 22 23 23 23 22 23 23 23 22 23 23 23 22 23 23 23 22 23 23 23 57
59 54 55 55 55 55 56 23 22 23 23 23 22 23 23 23 22 23 23 23 22 23 23 23 57
59 47 47 47 47 47 59 23 22 23 23 23 22 23 23 23 22 23 23 23 22 23 23 23 57
59 47 47 47 47 47 60 55 55 55 55 55 55 55 55 55 55 55 55 55 55 55 55 55 55
59 47 47 47 47 47 47 47 61 62 23 23 23 23 23 23 23 23 23 23 23 23 23 23 23
59 23 23 23 23 23 23 23 23 23 23 23 23 23 23 23 23 23 23 23 23 23 23 23 23
59 23 23 23 23 23 23 23 23 23 23 23 23 23 23 23 23 23 23 23 23 23 23 23 23
59 23 23 23 23 23 23 23 23 23 23 23 23 23 23 23 23 23 23 23 23 23 23 23 23
59 23 23 23 23 23 23 23 23 23 23 23 23 23 23 23 23 23 23 23 23 23 23 23 23
59 23 23 23 23 23 23 23 23 23 23 23 23 23 23 23 23 23 23 23 23 23 23 23 23
59 23 23 23 23 23 23 23 23 23 23 23 23 23 23 23 23 23 23 23 23 23 23 23 23
59 23 23 23 23 23 23 23 23 23 23 23 23 23 23 23 23 23 23 23 23 23 23 23 23