107
17
42 00 00 00 00 00 00 00 00 00 00 00 00 00 00 00 00 00 00 00 00 00 00 00 00 00 00 00 00 00 00 00 00 00 00 00 00 00 00 00 00 00 00 00 00 00 00 00 00 00 00 00 00 00 00 00 00 00 00 00 00 00 00 00 00 00 00 00 00 00 00 00 00 00 00 00 00 00 00 00 00 00 00 00 00 00 00 00 00 00 00 00 00 00 00 00 00 00 00 00 00 00 00 00 00 00 46
42 00 00 00 00 00 00 00 00 00 00 00 00 00 00 00 00 00 00 00 00 00 00 00 00 00 00 00 00 00 00 00 00 00 00 00 00 00 00 00 00 00 00 00 00 00 00 00 00 00 00 00 00 00 00 00 00 00 00 00 00 00 00 00 00 00 00 00 00 00 00 00 00 00 00 00 00 00 00 00 00 00 00 00 00 00 00 00 00 00 00 00 00 00 00 00 00 00 00 00 00 00 00 00 00 00 46
42 00 00 00 00 00 00 00 00 00 00 00 00 00 00 00 00 00 00 00 00 00 00 00 00 00 00 00 00 00 00 00 00 00 00 00 00 00 00 00 00 00 00 00 00 00 00 00 00 00 00 00 00 00 00 00 00 00 00 00 00 00 00 00 00 00 00 00 00 00 00 00 00 00 00 00 00 00 00 00 00 00 00 00 00 00 00 00 00 00 00 00 00 00 00 00 00 00 00 00 00 00 00 00 00 00 46
42 00 00 00 00 00 00 00 00 00 00 00 00 00 00 00 00 00 00 00 00 00 00 00 00 00 00 00 00 00 00 00 00 00 00 00 00 00 00 00 00 00 00 00 00 00 00 00 00 00 00 00 00 00 00 00 00 00 00 00 00 00 00 00 00 00 00 00 00 00 00 00 00 00 00 00 00 00 00 00 00 00 00 00 00 00 00 00 00 00 00 00 00 00 00 00 00 00 00 00 00 00 00 00 00 00 46
42 00 00 00 00 00 00 00 00 00 00 00 00 00 00 00 00 00 00 00 00 00 00 00 00 00 00 00 00 00 00 00 00 00 00 00 00 00 00 00 00 00 00 00 00 00 00 00 00 00 00 00 00 00 00 00 00 00 00 00 00 00 00 00 00 00 00 00 00 00 00 00 00 00 00 00 00 00 00 00 00 00 00 00 00 00 00 00 00 00 00 00 00 00 00 00 00 00 00 00 00 00 00 00 00 00 46
42 00 00 00 00 00 00 00 00 00 00 00 00 00 00 00 00 00 00 00 00 00 00 00 00 00 00 00 00 00 00 00 00 00 00 14 24 15 00 00 00 00 00 00 00 00 00 00 00 00 00 00 00 00 00 00 00 00 00 00 00 00 00 00 00 00 00 00 00 00 00 00 00 00 00 00 00 00 00 00 00 00 00 00 00 00 00 00 00 00 00 00 00 00 00 00 00 00 00 00 00 00 00 00 00 00 46
42 00 00 00 00 00 00 00 00 00 00 00 00 00 00 00 00 00 00 00 00 00 00 00 14 24 14 00 00 00 00 00 00 00 00 00 00 00 00 00 00 00 00 00 00 00 00 00 00 00 00 00 00 00 00 39 40 41 00 00 00 00 00 00 00 00 00 00 00 00 00 00 00 00 00 00 00 00 39 40 41 00 00 00 00 00 00 00 00 00 00 00 00 00 00 00 00 00 00 00 00 00 00 00 00 00 46
42 00 00 00 00 00 00 00 00 00 00 00 00 00 00 00 00 00 00 00 00 00 00 00 00 00 00 00 00 00 00 00 00 00 00 00 00 00 00 00 00 00 00 00 00 00 00 43 45 00 00 00 00 00 00 46 47 48 00 00 00 00 00 00 00 00 00 00 00 00 00 00 00 00 00 00 00 67 68 47 65 66 00 00 00 00 00 00 00 00 00 00 00 00 00 00 00 00 00 00 00 00 00 00 00 00 46
42 00 00 00 00 00 00 00 00 00 00 00 00 00 00 00 00 00 00 00 00 00 00 00 00 00 00 00 00 00 00 00 00 00 00 00 00 00 00 00 00 00 00 00 00 00 00 00 00 00 00 00 00 00 00 46 47 48 00 00 00 00 00 00 00 00 00 00 00 00 00 00 00 00 00 00 00 00 46 47 48 00 00 00 00 00 00 00 00 00 00 00 00 00 00 00 00 00 00 00 00 00 00 00 00 00 46
42 00 00 00 12 13 00 00 00 00 00 00 14 00 00 00 00 00 00 00 00 00 00 00 00 00 00 00 00 00 43 44 44 45 00 00 00 00 00 00 00 00 00 00 00 00 00 00 00 00 00 00 00 00 00 46 47 48 00 00 00 00 00 00 00 00 00 00 00 00 00 00 00 00 00 00 00 00 46 47 48 00 00 00 00 00 00 00 00 00 00 00 00 00 00 00 00 00 00 00 00 00 00 00 00 00 46
42 00 00 00 00 00 00 00 00 00 00 00 00 00 00 00 00 00 00 00 00 00 00 00 00 00 00 00 00 00 00 00 00 00 00 00 00 00 00 00 00 00 00 00 00 00 00 00 00 00 00 00 00 00 00 46 47 48 00 00 00 00 00 00 00 00 00 00 00 00 00 00 00 00 00 00 00 00 46 47 48 00 00 00 00 00 00 00 00 00 00 00 00 00 00 00 00 40 40 40 40 40 40 40 40 40 46
42 00 11 00 00 00 00 00 00 00 00 00 00 00 00 39 41 00 00 00 00 00 00 00 00 00 00 00 00 00 00 00 00 00 00 00 00 00 00 00 00 00 00 00 00 00 00 00 00 43 44 45 00 00 00 46 47 48 00 00 00 00 00 00 00 00 00 00 00 00 00 00 00 00 00 00 00 67 68 47 65 66 00 00 00 00 40 40 40 40 40 40 40 40 40 00 00 46 47 47 47 47 47 47 47 47 46
42 40 40 41 00 00 00 00 00 00 00 00 00 00 00 46 48 00 00 00 00 00 00 00 39 41 00 00 00 00 00 00 00 00 00 00 00 00 00 00 00 00 00 00 00 00 00 00 00 00 00 00 00 00 00 46 47 48 00 00 00 00 00 00 00 00 00 00 00 00 00 00 00 00 00 00 00 00 46 47 48 00 00 00 00 00 46 47 47 47 47 47 47 47 48 00 00 46 47 47 47 47 47 47 47 47 46
52 47 52 48 00 00 00 10 00 00 00 00 00 09 00 46 65 69 69 66 00 00 00 00 46 48 00 00 00 00 00 00 00 00 00 00 00 00 00 00 00 00 00 00 00 00 00 00 00 00 00 00 00 00 00 46 47 48 00 00 00 00 00 00 00 39 40 40 40 40 40 40 40 40 40 41 00 00 46 47 48 00 00 00 00 00 46 47 47 47 47 47 47 47 48 00 00 46 47 47 47 47 47 47 47 47 46
47 52 47 63 40 40 40 40 40 40 40 40 40 40 40 64 48 00 00 00 00 00 39 40 64 63 41 00 00 00 00 00 00 00 00 00 00 00 00 00 00 00 00 39 40 40 41 00 00 00 00 00 00 00 39 64 47 63 41 00 00 00 00 00 00 46 47 47 47 47 47 47 47 47 47 48 00 00 46 47 48 00 00 00 00 00 46 47 47 47 47 47 47 47 48 00 00 46 47 47 47 47 47 47 47 47 46
47 47 47 52 47 47 47 52 47 47 47 47 52 47 47 47 48 00 00 00 00 00 46 47 47 47 48 00 00 00 00 00 00 00 00 00 00 00 00 00 00 00 00 46 47 47 48 00 00 00 00 00 00 00 46 47 47 47 48 00 00 00 00 00 00 46 47 47 47 47 47 47 47 47 47 48 00 00 46 47 48 00 00 00 00 00 46 47 47 47 47 47 47 47 48 00 00 46 47 47 47 47 47 47 47 47 46
47 47 47 47 47 52 47 47 47 47 47 47 47 47 47 47 48 00 00 00 00 00 46 47 47 47 48 00 00 00 00 00 00 00 00 00 00 00 00 00 00 00 00 46 47 47 48 00 00 00 00 00 00 00 46 47 47 47 48 00 00 00 00 00 00 46 47 47 47 47 47 47 47 47 47 48 00 00 46 47 48 00 00 00 00 00 46 47 47 47 47 47 47 47 48 00 00 46 47 47 47 47 47 47 47 47 46