121
20
71 56 56 56 56 56 56 56 56 56 71 50 51 51 71 62 62 62 62 62 62 62 62 62 62 62 62 62 62 71 71 62 62 62 62 62 62 62 62 62 62 62 62 62 62 62 62 62 62 62 62 62 62 62 62 62 62 62 62 62 62 62 62 62 62 62 62 62 62 62 62 62 62 62 62 62 62 62 62 62 62 62 62 62 62 62 62 62 62 62 62 62 62 62 62 62 62 62 62 62 62 62 62 62 62 62 62 62 62 62 62 62 62 62 62 62 62 62 62 71 0
58 36 36 36 23 36 36 36 23 36 58 50 50 51 60 36 23 36 24 24 23 24 36 36 23 36 36 36 23 58 60 36 23 36 36 36 23 36 36 36 23 36 36 36 23 36 36 36 23 36 36 36 23 36 36 35 23 36 36 36 23 36 36 36 23 36 36 36 23 36 36 36 23 36 36 36 23 36 36 36 23 36 36 36 23 36 36 35 23 36 36 36 23 36 36 36 23 36 36 36 23 36 36 36 23 36 36 36 23 36 36 36 23 36 36 36 23 36 36 58 0
58 36 22 36 23 36 22 36 23 36 58 52 50 51 60 36 23 36 22 36 23 36 22 36 23 36 22 36 23 58 60 36 23 36 22 36 23 36 22 36 23 36 22 36 23 36 22 36 23 36 22 36 23 36 22 36 23 36 22 36 23 36 22 36 23 36 22 36 23 36 22 36 23 36 22 36 23 36 22 36 23 36 22 36 23 36 22 36 23 36 22 36 23 36 36 36 23 36 36 36 23 36 36 36 23 36 36 36 23 36 36 36 23 36 36 36 23 36 36 58 0
58 36 36 36 23 36 36 36 23 36 58 52 50 50 60 36 23 36 36 36 23 36 36 36 23 36 36 36 23 58 60 36 23 36 36 36 23 36 36 36 23 36 36 36 23 36 36 36 23 36 36 36 23 36 36 36 23 36 36 36 23 36 36 36 23 36 36 36 23 36 36 36 23 36 36 36 23 36 36 36 23 36 36 36 23 36 36 36 23 36 36 36 23 36 36 36 23 36 36 36 23 36 36 36 23 36 36 36 23 36 36 36 23 36 36 36 23 36 36 58 0
58 36 36 36 23 36 36 36 23 36 58 50 53 50 60 36 23 36 36 36 23 36 36 36 23 36 36 36 23 58 60 36 23 36 36 36 23 36 36 36 23 36 36 36 23 36 36 36 23 36 36 36 23 36 36 36 23 36 36 36 23 36 36 36 23 36 36 36 23 36 36 35 23 36 36 36 23 36 36 55 56 57 36 36 23 36 36 36 23 36 36 36 23 36 36 36 23 36 36 36 23 36 36 36 23 36 36 36 23 36 36 36 23 36 36 36 23 36 36 58 0
71 62 62 62 62 62 71 36 23 36 58 50 50 50 60 36 23 36 36 36 55 56 56 56 57 36 36 36 23 58 60 36 23 36 36 36 23 36 36 36 23 36 36 36 23 36 36 36 23 36 36 36 23 36 36 36 23 36 36 36 23 36 36 36 23 36 36 36 23 36 36 35 23 36 36 36 23 36 36 58 53 60 36 36 23 36 36 36 23 36 36 36 23 36 36 36 23 36 36 36 23 36 36 36 23 36 36 36 23 36 36 36 23 36 36 36 23 36 36 58 0
43 51 43 43 43 43 60 36 23 36 71 62 62 62 71 24 23 36 36 36 61 62 62 62 63 36 36 36 23 58 60 36 23 36 36 36 23 36 36 36 23 36 36 36 23 36 36 36 23 36 36 36 23 36 36 36 23 36 36 36 23 36 36 36 23 36 36 55 56 57 35 35 23 36 36 36 23 36 36 58 53 60 36 36 23 36 36 36 23 36 36 36 23 36 36 36 23 36 36 36 23 36 36 36 23 36 36 36 23 36 36 36 23 36 36 36 23 36 36 58 0
43 43 43 43 52 43 60 36 23 36 36 36 23 36 36 36 23 36 35 35 23 35 35 35 23 36 36 36 23 61 63 36 23 36 36 36 23 36 36 36 23 36 36 36 23 36 36 36 23 36 36 36 23 36 36 36 23 36 36 36 23 36 36 36 23 36 36 58 53 60 36 35 23 36 36 36 23 68 70 69 53 60 36 36 23 36 36 36 23 36 36 36 23 36 36 36 23 36 36 36 23 36 36 36 23 36 36 36 23 36 36 36 23 36 36 36 23 36 36 58 0
43 43 43 43 43 43 60 36 23 36 22 36 23 36 22 36 23 36 22 35 23 35 22 35 23 36 22 36 23 36 22 36 23 36 22 36 23 36 22 36 23 36 22 36 23 36 22 36 23 36 22 36 23 36 22 36 23 36 22 36 23 36 22 36 23 36 22 58 53 60 22 36 23 36 22 36 23 36 22 58 53 60 22 36 23 36 22 36 23 36 22 36 23 36 36 36 23 36 36 36 23 36 36 36 23 36 36 36 23 36 36 36 23 36 36 36 23 36 36 58 0
43 43 43 43 43 43 60 36 23 36 36 36 23 36 36 36 23 36 36 36 23 36 36 36 23 36 36 36 23 36 36 36 23 36 36 36 23 36 36 36 23 36 36 36 23 36 36 36 23 36 36 36 55 56 56 56 56 71 36 36 23 36 36 36 23 36 36 58 53 60 36 36 23 36 36 36 23 36 36 58 53 60 36 36 23 36 36 36 23 36 36 36 23 36 36 36 23 36 36 36 23 36 36 36 23 36 36 36 23 36 36 36 23 23 23 23 23 23 23 58 0
52 43 43 51 43 43 60 36 23 36 71 56 56 56 56 71 23 36 36 36 23 36 36 36 23 36 36 36 23 36 36 36 23 36 36 36 23 36 36 36 23 36 36 36 23 36 36 36 23 36 36 36 58 43 43 43 43 60 36 36 23 36 36 36 23 36 36 58 53 66 70 67 23 36 36 36 23 36 36 58 53 60 36 36 23 36 36 36 23 36 36 36 23 36 36 36 23 36 36 36 23 36 36 36 23 36 36 36 23 36 36 36 23 36 36 36 36 36 36 58 0
43 43 43 43 43 43 60 36 23 36 58 43 43 43 43 60 23 36 36 36 23 36 36 36 23 36 36 36 23 35 35 35 23 36 36 36 23 36 36 36 55 57 36 36 23 36 36 36 23 36 36 36 58 43 43 43 43 60 36 36 23 36 36 36 23 36 36 58 53 60 36 36 23 36 36 36 23 36 36 58 53 60 36 36 23 36 36 36 23 36 36 36 23 36 36 36 23 36 36 36 23 36 36 36 23 36 36 36 23 36 36 35 23 36 36 36 36 36 36 58 0
43 43 43 43 52 43 60 36 23 36 58 43 53 43 43 60 23 36 36 36 23 36 36 36 23 36 36 36 23 55 57 36 23 36 36 36 23 36 36 36 61 63 36 36 23 36 36 36 23 36 36 36 58 43 43 43 43 71 56 56 56 56 71 36 23 36 36 58 53 60 36 36 23 36 36 36 23 36 36 58 53 60 36 36 23 36 36 36 23 36 36 36 23 36 36 36 23 36 36 36 23 36 36 36 23 36 36 36 23 36 36 35 55 57 36 22 22 22 36 58 0
43 43 43 43 43 43 60 36 23 36 58 43 43 43 53 60 23 36 36 36 23 36 36 36 23 36 36 36 23 58 60 36 23 36 36 36 23 36 36 36 23 36 36 36 23 55 57 36 23 36 36 36 58 43 43 43 43 43 43 43 43 43 60 36 23 36 36 58 53 60 36 36 23 36 36 36 23 36 36 58 53 60 36 36 23 36 36 36 23 36 36 36 23 36 36 36 23 36 36 36 23 36 36 36 23 36 36 36 23 36 36 36 58 60 36 22 22 22 36 58 0
43 51 43 51 43 43 71 62 62 62 71 43 43 43 43 60 23 36 36 35 55 56 56 56 57 36 36 36 23 58 60 36 23 36 36 36 23 36 36 36 23 36 36 36 23 58 60 36 23 36 36 36 58 43 43 43 43 43 43 43 43 43 60 36 23 36 36 58 53 60 36 36 23 36 36 36 23 36 36 58 53 60 36 36 23 36 36 36 23 36 36 36 23 36 36 36 23 36 36 36 23 36 36 36 23 36 36 36 23 36 36 36 58 60 36 36 36 36 36 58 0
43 43 43 43 43 43 43 43 43 43 43 43 43 53 43 60 23 36 22 35 61 62 62 62 63 36 22 36 23 58 60 36 23 36 55 57 23 36 22 36 23 36 22 36 23 58 60 36 23 36 22 36 58 43 43 43 43 43 43 43 43 43 60 36 23 36 36 61 62 62 36 36 23 36 36 36 68 70 70 69 53 60 36 36 23 36 36 36 23 36 36 36 23 36 36 36 23 36 36 36 23 36 36 36 23 36 36 36 23 36 36 36 58 60 36 36 36 36 36 58 0
43 43 43 43 52 43 53 43 43 51 43 53 43 43 43 60 23 36 36 36 23 36 36 36 23 36 36 36 23 58 60 36 23 36 61 63 23 36 36 36 23 36 36 36 23 58 60 36 23 36 36 36 58 43 43 43 43 43 43 43 43 43 60 36 23 36 36 36 23 36 36 36 23 36 36 36 23 36 36 58 53 60 36 36 23 36 36 36 23 36 36 36 23 36 36 36 23 36 36 36 23 36 36 36 23 36 36 36 23 36 36 36 58 60 36 36 36 36 36 58 0
43 52 43 43 43 43 43 43 43 43 43 43 43 43 43 60 23 36 36 36 23 36 36 36 23 36 36 36 23 58 60 35 35 35 35 35 35 35 35 36 23 36 36 36 23 58 60 36 23 36 36 36 58 43 43 43 43 43 43 43 43 43 60 36 23 36 22 36 23 36 22 36 23 36 22 36 23 36 36 58 53 60 36 36 23 36 36 36 23 36 36 36 23 36 36 36 23 36 36 36 23 36 36 36 23 36 36 36 23 36 36 36 58 60 36 36 36 36 36 58 0
43 53 43 43 43 43 43 53 43 43 43 53 43 43 43 60 23 36 36 36 23 36 36 36 23 36 36 36 23 58 71 56 56 56 56 56 56 56 56 56 56 56 56 56 56 71 60 36 23 36 36 36 58 43 43 43 43 43 43 43 43 43 60 36 23 36 36 36 23 36 36 36 23 36 36 36 23 36 36 58 53 60 36 36 23 36 36 36 23 36 36 36 23 36 36 36 23 36 36 36 23 36 36 36 23 36 36 36 23 36 36 36 71 71 71 71 71 71 71 58 0
43 43 43 43 53 43 43 43 43 52 43 43 43 43 53 60 23 36 36 36 23 36 36 36 23 36 36 36 23 58 43 43 43 43 43 43 43 43 43 43 43 43 43 43 43 43 60 36 23 36 36 36 58 43 43 43 43 43 43 43 43 43 60 36 23 36 36 55 56 56 56 56 56 57 36 36 23 36 36 58 53 60 36 36 23 36 36 36 23 36 36 36 23 36 36 36 23 36 36 36 23 36 36 36 23 36 36 36 23 36 36 36 71 71 71 71 71 71 71 58 00