120
20
70 55 55 55 55 55 55 55 55 55 70 49 50 50 70 61 61 61 61 61 61 61 61 61 61 61 61 61 61 70 70 61 61 61 61 61 61 61 61 61 61 61 61 61 61 61 61 61 61 61 61 61 61 61 61 61 61 61 61 61 61 61 61 61 61 61 61 61 61 61 61 61 61 61 61 61 61 61 61 61 61 61 61 61 61 61 61 61 61 61 61 61 61 61 61 70 52 70 61 61 61 61 61 61 61 61 61 61 61 61 61 61 61 61 61 61 61 61 61 70 
57 35 35 35 22 35 35 35 22 35 57 49 49 50 59 35 22 35 35 35 22 35 35 35 22 35 35 35 22 57 59 35 22 35 35 35 22 35 35 35 22 35 35 35 22 35 35 35 22 35 35 35 22 35 35 35 22 35 35 35 22 35 35 35 22 35 35 35 22 35 35 35 22 35 35 35 22 35 35 35 22 35 35 35 22 35 35 35 22 35 35 35 22 35 35 57 52 59 35 35 22 35 35 35 22 35 35 35 22 35 35 35 22 35 35 35 22 35 35 57 
57 35 21 35 22 35 21 35 22 35 57 51 49 50 59 35 22 35 21 35 22 35 21 35 22 35 21 35 22 57 59 35 22 35 21 35 22 35 21 35 22 35 21 35 22 35 21 35 22 35 21 35 22 35 21 35 22 35 21 35 22 35 21 35 22 35 21 35 22 35 21 35 22 35 21 35 22 35 21 35 22 35 21 35 22 35 21 35 22 35 21 35 22 35 35 57 52 59 35 35 22 35 21 35 22 35 21 35 22 35 21 35 22 35 21 35 22 35 35 57 
57 35 35 35 22 35 35 35 22 35 57 51 49 49 59 35 22 35 35 35 22 35 35 35 22 35 35 35 22 57 59 35 22 35 35 35 22 35 35 35 22 35 35 35 22 35 35 35 22 35 35 35 22 35 35 35 22 35 35 35 22 35 35 35 22 35 35 35 22 35 35 35 22 35 35 35 22 35 35 35 22 35 35 35 22 35 35 35 22 35 35 35 22 35 35 57 52 59 35 35 22 35 35 35 22 35 35 35 22 35 35 35 22 35 35 35 22 35 35 57 
57 35 35 35 22 35 35 35 22 35 57 49 52 49 59 35 22 35 35 35 22 35 35 35 22 35 35 35 22 57 59 35 22 35 35 35 22 35 35 35 22 35 35 35 22 35 35 35 22 35 35 35 22 35 35 35 22 35 35 35 22 35 35 35 22 35 35 35 22 35 35 35 22 35 35 35 22 35 35 54 55 56 35 35 22 35 35 35 22 35 35 35 22 35 35 57 52 59 35 35 22 35 35 35 22 35 35 35 22 35 35 35 22 35 35 35 22 35 35 57 
70 61 61 61 61 61 70 35 22 35 57 49 49 49 59 35 22 35 35 35 54 55 55 55 56 35 35 35 22 57 59 35 22 35 35 35 22 35 35 35 22 35 35 35 22 35 35 35 22 35 35 35 22 35 35 35 22 35 35 35 22 35 35 35 22 35 35 35 22 35 35 35 22 35 35 35 22 35 35 57 52 59 35 35 22 35 35 54 55 55 55 55 70 35 35 57 52 59 35 35 22 35 35 35 22 54 55 56 22 35 35 35 22 35 35 35 22 35 35 57 
42 50 42 42 42 42 59 35 22 35 70 61 61 61 70 35 22 35 35 35 60 61 61 61 62 35 35 35 22 57 59 35 22 35 35 35 22 35 35 35 22 35 35 35 22 35 35 35 22 35 35 35 22 35 35 35 22 35 35 35 22 35 35 35 22 35 35 54 55 56 35 35 22 35 35 35 22 35 35 57 52 59 35 35 22 35 35 57 52 52 52 52 59 35 35 57 52 59 35 35 22 35 35 35 22 60 61 62 22 35 35 35 22 35 35 35 22 35 35 57 
42 42 42 42 51 42 59 35 22 35 35 35 22 35 35 35 22 35 35 35 22 35 35 35 22 35 35 35 22 60 62 35 22 35 35 35 22 35 35 35 22 35 35 35 22 35 35 35 22 35 35 35 22 35 35 35 22 35 35 35 22 35 35 35 22 35 35 57 52 59 35 35 22 35 35 35 22 67 69 68 52 59 35 35 22 35 35 57 52 52 52 52 59 35 35 57 52 59 35 35 22 35 35 35 22 35 35 35 22 35 35 35 22 35 35 35 22 35 35 57 
42 42 42 42 42 42 59 35 22 35 21 35 22 35 21 35 22 35 21 35 22 35 21 35 22 35 21 35 22 35 21 35 22 35 21 35 22 35 21 35 22 35 21 35 22 35 21 35 22 35 21 35 22 35 21 35 22 35 21 35 22 35 21 35 22 35 21 57 52 59 21 35 22 35 21 35 22 35 21 57 52 59 35 35 22 35 35 57 52 52 52 52 59 35 35 57 52 59 35 35 22 35 21 35 22 35 21 35 22 35 21 35 22 35 35 35 22 35 35 57 
42 42 42 42 42 42 59 35 22 35 35 35 22 35 35 35 22 35 35 35 22 35 35 35 22 35 35 35 22 35 35 35 22 35 35 35 22 35 35 35 22 35 35 35 22 35 35 35 22 35 35 35 54 55 55 55 55 70 35 35 22 35 35 35 22 35 35 57 52 59 35 35 22 35 35 35 22 35 35 57 52 59 35 35 22 35 35 57 52 52 52 52 59 35 35 57 52 59 35 35 22 35 35 35 22 35 35 35 22 35 35 35 54 56 35 35 22 35 35 57 
51 42 42 50 42 42 59 35 22 35 70 55 55 55 55 70 22 35 35 35 22 35 35 35 22 35 35 35 22 35 35 35 22 35 35 35 22 35 35 35 22 35 35 35 22 35 35 35 22 35 35 35 57 42 42 42 42 59 35 35 22 35 35 35 22 35 35 57 52 65 69 66 22 35 35 35 22 35 35 57 52 70 55 55 55 55 55 70 52 52 52 52 59 35 35 57 52 65 69 66 22 35 35 35 22 35 35 35 22 35 35 35 57 59 35 35 22 35 35 57 
42 42 42 42 42 42 59 35 22 35 57 42 42 42 42 59 22 35 35 35 22 35 35 35 22 35 35 35 22 35 35 35 22 35 35 35 22 35 35 35 54 56 35 35 22 35 35 35 22 35 35 35 57 42 42 42 42 59 35 35 22 35 35 35 22 35 35 57 52 59 35 35 22 35 35 35 22 35 35 57 52 70 61 61 61 61 61 70 61 61 61 61 61 35 35 57 52 59 35 35 22 35 35 35 22 35 35 35 22 35 35 35 57 59 22 22 22 22 22 57 
42 42 42 42 51 42 59 35 22 35 57 42 52 42 42 59 22 35 35 35 22 35 35 35 22 35 35 35 22 54 56 35 22 35 35 35 22 35 35 35 60 62 35 35 22 35 35 35 22 35 35 35 57 42 42 42 42 70 55 55 55 55 70 35 22 35 35 57 52 59 35 35 22 35 35 35 22 35 35 57 52 59 35 35 22 35 35 35 22 35 35 35 22 35 35 57 52 59 35 35 22 35 35 35 22 35 35 35 22 35 35 35 57 59 35 35 35 35 35 57 
42 42 42 42 42 42 59 35 22 35 57 42 42 42 52 59 22 35 35 35 22 35 35 35 22 35 35 35 22 57 59 35 22 35 35 35 22 35 35 35 22 35 35 35 22 54 56 35 22 35 35 35 57 42 42 42 42 42 42 42 42 42 59 35 22 35 35 57 52 59 35 35 22 35 35 35 22 35 35 57 52 59 35 35 22 35 35 35 22 35 35 35 22 35 35 57 52 59 35 35 22 35 35 35 22 35 35 35 22 35 35 35 57 59 35 35 21 35 35 57 
42 50 42 50 42 42 70 61 61 61 70 42 42 42 42 59 22 35 35 35 54 55 55 55 56 35 35 35 22 57 59 35 22 35 35 35 22 35 35 35 22 35 35 35 22 57 59 35 22 35 35 35 57 42 42 42 42 42 42 42 42 42 59 35 22 35 35 57 52 59 35 35 22 35 35 35 22 35 35 57 52 59 35 35 54 55 55 55 55 55 55 55 56 35 35 57 52 59 35 35 22 35 35 35 22 35 35 35 22 35 35 35 57 59 35 35 35 35 35 57 
42 42 42 42 42 42 42 42 42 42 42 42 42 52 42 59 22 35 21 35 60 61 61 61 62 35 21 35 22 57 59 35 22 35 54 56 22 35 21 35 22 35 21 35 22 57 59 35 22 35 21 35 57 42 42 42 42 42 42 42 42 42 59 35 22 35 35 60 61 61 35 35 22 35 35 35 67 69 69 68 52 59 35 35 57 52 52 52 52 52 52 52 59 35 35 57 52 59 35 35 22 35 54 55 56 35 21 35 22 35 21 35 57 59 35 35 35 35 35 57 
42 42 42 42 51 42 52 42 42 50 42 52 42 42 42 59 22 35 35 35 22 35 35 35 22 35 35 35 22 57 59 35 22 35 60 62 22 35 35 35 22 35 35 35 22 57 59 35 22 35 35 35 57 42 42 42 42 42 42 42 42 42 59 35 22 35 35 35 22 35 35 35 22 35 35 35 22 35 35 57 52 59 35 35 60 61 61 61 61 61 61 61 70 55 55 70 61 70 35 35 22 35 60 61 62 35 35 35 22 35 35 35 57 59 35 35 35 35 35 57 
42 51 42 42 42 42 42 42 42 42 42 42 42 42 42 59 22 35 35 35 22 35 35 35 22 35 35 35 22 57 59 35 35 35 35 35 35 35 35 35 22 35 35 35 22 57 59 35 22 35 35 35 57 42 42 42 42 42 42 42 42 42 59 35 22 35 21 35 22 35 21 35 22 35 21 35 22 35 35 57 52 59 35 35 22 35 35 35 22 35 35 35 22 35 35 35 22 35 35 35 22 35 35 35 22 35 35 35 22 35 35 35 57 59 35 35 35 35 35 57 
42 52 42 42 42 42 42 52 42 42 42 52 42 42 42 59 22 35 35 35 22 35 35 35 22 35 35 35 22 57 70 55 55 55 55 55 55 55 55 55 55 55 55 55 55 70 59 35 22 35 35 35 57 42 42 42 42 42 42 42 42 42 59 35 22 35 35 35 22 35 35 35 22 35 35 35 22 35 35 57 52 59 35 35 22 35 35 35 22 35 35 35 22 35 35 35 22 35 35 35 22 35 35 35 22 35 35 35 22 35 35 35 70 70 70 70 70 70 70 57 
42 42 42 42 52 42 42 42 42 51 42 42 42 42 52 59 22 35 35 35 22 35 35 35 22 35 35 35 22 57 42 42 42 42 42 42 42 42 42 42 42 42 42 42 42 42 59 35 22 35 35 35 57 42 42 42 42 42 42 42 42 42 59 35 22 35 35 54 55 55 55 55 55 56 35 35 22 35 35 57 52 59 35 35 55 55 55 55 55 55 55 55 55 55 55 55 55 55 35 35 22 35 35 35 22 35 35 35 22 35 35 35 70 70 70 70 70 70 70 57